D00000011111101
011110011111101
011110111111001
011110001111001
011110000000001
000000000000001
000110111101111
001111111111111
000000000000001
000000000000001
000000000000001
000000011111101
011110011111101
011110111111A01
111111111111111
